"seller_pk","available_inventory","available_inventory_is_clone","available_inventory_is_clone_of_available_item","difference","percent"
"a_6523","6188","6052","2922","3130","51.7184401850628"
"f_8226","2911","1985","0","1985","100"
"j_1282","2218","1084","57","1027","94.7416974169742"
"a_6593","1554","1275","275","1000","78.4313725490196"
"f_9331","2458","1071","86","985","91.9701213818861"
"v_439","1062","952","8","944","99.1596638655462"
"f_12002","1786","931","30","901","96.7776584317938"
"v_842","10642","846","10","836","98.8179669030733"
"f_39053","1200","1119","442","677","60.5004468275246"
"a_8531","689","671","2","669","99.7019374068554"
"f_9741","857","782","127","655","83.7595907928389"
"a_4683","877","809","158","651","80.4697156983931"
"a_4643","2075","1251","603","648","51.7985611510791"
"f_24363","796","724","81","643","88.8121546961326"
"a_4713","858","622","4","618","99.3569131832797"
"v_2592","1692","1024","487","537","52.44140625"
"a_1612","1532","929","397","532","57.2658772874058"
"f_12892","918","776","252","524","67.5257731958763"
"j_1012","819","616","99","517","83.9285714285714"
"a_3543","734","613","101","512","83.5236541598695"
"f_27123","584","504","4","500","99.2063492063492"
"j_9641","936","894","416","478","53.4675615212528"
"v_5503","2803","592","122","470","79.3918918918919"
"f_9474","1420","445","12","433","97.3033707865169"
"f_21313","589","575","146","429","74.6086956521739"
"f_26453","745","416","0","416","100"
"f_16322","444","441","26","415","94.1043083900227"
"f_9302","713","628","213","415","66.0828025477707"
"f_32663","824","779","365","414","53.1450577663671"
"v_511","753","406","0","406","100"
"f_14412","443","428","22","406","94.8598130841121"
"a_6213","441","433","32","401","92.6096997690531"
"f_9737","1524","688","303","385","55.9593023255814"
"f_20653","609","377","5","372","98.6737400530504"
"v_6123","912","646","274","372","57.5851393188854"
"f_14352","490","359","0","359","100"
"f_10962","739","399","42","357","89.4736842105263"
"a_6893","556","541","186","355","65.6192236598891"
"f_13082","1053","354","0","354","100"
"v_3592","1359","566","214","352","62.1908127208481"
"a_2982","1367","656","317","339","51.6768292682927"
"j_9081","978","338","1","337","99.7041420118343"
"f_9068","1469","603","268","335","55.5555555555556"
"f_9314","455","348","14","334","95.9770114942529"
"f_7972","733","357","23","334","93.5574229691877"
"v_3562","413","384","53","331","86.1979166666667"
"f_36163","538","534","204","330","61.7977528089888"
"f_9137","1176","358","33","325","90.7821229050279"
"a_197","729","498","178","320","64.2570281124498"
"j_7993","525","473","157","316","66.8076109936575"
"j_4042","792","467","158","309","66.1670235546039"
"f_23413","1369","402","96","306","76.1194029850746"
"v_6023","534","419","113","306","73.0310262529833"
"a_3082","778","520","216","304","58.4615384615385"
"v_14052","518","495","194","301","60.8080808080808"
"j_4223","725","390","94","296","75.8974358974359"
"f_9307","304","296","4","292","98.6486486486486"
"f_10630","392","341","49","292","85.6304985337243"
"f_25253","336","314","33","281","89.4904458598726"
"f_9334","908","349","68","281","80.5157593123209"
"a_11892","484","483","202","281","58.1780538302277"
"f_18503","488","393","116","277","70.4834605597964"
"v_58","365","356","80","276","77.5280898876404"
"f_24703","678","422","160","262","62.085308056872"
"f_9476","522","262","1","261","99.618320610687"
"f_17822","801","270","9","261","96.6666666666667"
"a_524","316","259","1","258","99.6138996138996"
"a_982","736","495","238","257","51.9191919191919"
"j_13183","1032","340","86","254","74.7058823529412"
"f_26353","270","259","11","248","95.7528957528958"
"f_30673","647","377","135","242","64.1909814323607"
"f_10208","443","344","107","237","68.8953488372093"
"j_10033","448","351","114","237","67.5213675213675"
"f_24563","1597","309","76","233","75.4045307443366"
"f_19083","285","270","39","231","85.5555555555556"
"f_26383","322","311","85","226","72.6688102893891"
"f_17532","867","359","133","226","62.9526462395543"
"f_18533","754","420","194","226","53.8095238095238"
"v_336","660","296","76","220","74.3243243243243"
"v_5203","339","269","51","218","81.0408921933086"
"j_7593","421","218","1","217","99.5412844036697"
"f_21303","401","336","122","214","63.6904761904762"
"a_3503","538","350","137","213","60.8571428571429"
"j_4022","230","230","19","211","91.7391304347826"
"f_24473","676","332","126","206","62.0481927710843"
"f_21263","210","209","4","205","98.0861244019139"
"f_19923","382","310","105","205","66.1290322580645"
"a_189","928","392","189","203","51.7857142857143"
"a_5683","297","228","26","202","88.5964912280702"
"j_14782","351","351","151","200","56.980056980057"
"f_27713","518","216","17","199","92.1296296296296"
"f_9718","295","205","8","197","96.0975609756098"
"f_9891","636","382","187","195","51.0471204188482"
"v_386","904","202","10","192","95.049504950495"
"j_732","266","207","15","192","92.7536231884058"
"j_5903","761","244","53","191","78.2786885245902"
"f_32301","673","191","1","190","99.4764397905759"
"a_8421","366","363","173","190","52.3415977961433"
"f_28323","309","303","114","189","62.3762376237624"
"a_1032","2533","277","89","188","67.870036101083"
"f_11242","430","190","3","187","98.4210526315789"
"f_7805","919","217","31","186","85.7142857142857"
"v_238","251","183","2","181","98.9071038251366"
"f_8487","397","216","38","178","82.4074074074074"
"v_550","495","181","4","177","97.7900552486188"
"j_69","555","279","102","177","63.4408602150538"
"j_3892","670","178","3","175","98.314606741573"
"f_36223","242","223","53","170","76.2331838565022"
"a_7043","266","180","11","169","93.8888888888889"
"a_237","629","307","140","167","54.3973941368078"
"f_18323","512","297","131","166","55.8922558922559"
"f_8838","603","165","2","163","98.7878787878788"
"v_10313","230","230","68","162","70.4347826086957"
"v_586","373","273","113","160","58.6080586080586"
"f_10590","461","159","0","159","100"
"a_12941","209","179","20","159","88.8268156424581"
"f_22553","324","214","56","158","73.8317757009346"
"v_588","1251","195","39","156","80"
"f_17262","771","264","109","155","58.7121212121212"
"f_9110","359","188","34","154","81.9148936170213"
"f_33433","320","247","95","152","61.5384615384615"
"j_10563","244","242","91","151","62.396694214876"
"v_4163","544","264","113","151","57.1969696969697"
"f_8903","1632","204","54","150","73.5294117647059"
"f_9728","251","149","0","149","100"
"f_11412","376","151","2","149","98.6754966887417"
"a_9691","200","194","45","149","76.8041237113402"
"a_3392","351","276","128","148","53.6231884057971"
"v_2012","451","206","59","147","71.3592233009709"
"f_13332","237","218","71","147","67.4311926605505"
"v_1822","262","218","71","147","67.4311926605505"
"f_15302","583","147","3","144","97.9591836734694"
"f_18293","654","144","2","142","98.6111111111111"
"f_18083","205","167","28","139","83.2335329341317"
"j_6703","199","176","37","139","78.9772727272727"
"f_8486","505","213","75","138","64.7887323943662"
"f_44432","317","245","107","138","56.3265306122449"
"a_812","217","170","33","137","80.5882352941176"
"f_23733","352","174","37","137","78.735632183908"
"f_9528","322","136","0","136","100"
"f_9585","424","229","94","135","58.9519650655022"
"f_18353","369","257","122","135","52.5291828793774"
"j_455","201","135","1","134","99.2592592592593"
"f_23123","196","132","0","132","100"
"f_13992","137","134","2","132","98.5074626865672"
"f_8632","2391","156","24","132","84.6153846153846"
"a_5631","180","164","32","132","80.4878048780488"
"j_13223","201","200","68","132","66"
"f_27273","405","176","45","131","74.4318181818182"
"f_26323","234","227","96","131","57.7092511013216"
"f_12062","420","248","118","130","52.4193548387097"
"f_42391","251","175","46","129","73.7142857142857"
"v_1872","255","212","83","129","60.8490566037736"
"j_11711","336","213","84","129","60.5633802816901"
"f_10972","515","149","21","128","85.9060402684564"
"f_10824","607","231","103","128","55.4112554112554"
"f_9366","1213","217","92","125","57.6036866359447"
"a_263","214","134","10","124","92.5373134328358"
"f_9381","285","164","41","123","75"
"f_43422","198","171","50","121","70.7602339181287"
"a_4153","667","125","5","120","96"
"a_5193","318","157","38","119","75.796178343949"
"f_30903","171","169","52","117","69.2307692307692"
"f_29573","379","181","65","116","64.0883977900552"
"f_9730","576","121","6","115","95.0413223140496"
"f_13142","951","174","59","115","66.0919540229885"
"j_14012","115","114","2","112","98.2456140350877"
"f_10352","176","120","9","111","92.5"
"j_197","1330","113","3","110","97.3451327433628"
"v_4423","1164","154","44","110","71.4285714285714"
"f_17202","290","195","85","110","56.4102564102564"
"j_13103","1109","110","1","109","99.0909090909091"
"f_16872","250","140","31","109","77.8571428571429"
"v_7573","575","108","1","107","99.0740740740741"
"j_5053","320","143","36","107","74.8251748251748"
"f_22003","188","187","80","107","57.2192513368984"
"f_24613","184","106","0","106","100"
"f_9379","712","133","27","106","79.6992481203008"
"f_18363","186","154","48","106","68.8311688311688"
"f_10744","443","182","76","106","58.2417582417582"
"a_7693","320","194","88","106","54.639175257732"
"f_9939","128","105","0","105","100"
"f_20723","176","119","14","105","88.2352941176471"
"f_9187","277","119","15","104","87.3949579831933"
"f_33183","177","142","38","104","73.2394366197183"
"f_15312","353","182","78","104","57.1428571428571"
"a_284","253","114","11","103","90.3508771929825"
"f_8112","823","171","68","103","60.233918128655"
"f_21603","264","178","75","103","57.8651685393258"
"f_29473","120","104","2","102","98.0769230769231"
"f_8080","652","160","59","101","63.125"
"a_5403","320","102","2","100","98.0392156862745"
"f_28393","184","117","17","100","85.4700854700855"
"f_20883","196","158","58","100","63.2911392405063"
"f_12492","168","137","38","99","72.2627737226277"
"v_768","926","108","10","98","90.7407407407407"
"v_4052","435","116","18","98","84.4827586206897"
"j_122","345","125","27","98","78.4"
"f_36503","129","128","30","98","76.5625"
"f_27673","144","100","3","97","97"
"f_22343","241","170","73","97","57.0588235294118"
"j_4122","96","96","0","96","100"
"j_4373","365","117","21","96","82.0512820512821"
"f_21933","342","120","24","96","80"
"f_21823","125","121","25","96","79.3388429752066"
"f_9799","204","124","28","96","77.4193548387097"
"j_784","743","103","8","95","92.2330097087379"
"f_18133","254","110","15","95","86.3636363636364"
"a_344","829","172","77","95","55.2325581395349"
"f_12802","251","156","62","94","60.2564102564103"
"v_128","487","92","0","92","100"
"f_8832","2336","107","15","92","85.981308411215"
"f_10320","245","125","33","92","73.6"
"f_17432","382","132","42","90","68.1818181818182"
"f_8514","403","96","7","89","92.7083333333333"
"f_39443","490","108","19","89","82.4074074074074"
"f_30203","229","88","0","88","100"
"f_22333","129","105","17","88","83.8095238095238"
"a_5373","163","116","28","88","75.8620689655172"
"j_320","222","117","30","87","74.3589743589744"
"f_27133","270","152","65","87","57.2368421052632"
"f_9452","431","162","76","86","53.0864197530864"
"f_30443","939","90","5","85","94.4444444444444"
"v_12641","143","110","25","85","77.2727272727273"
"j_8963","151","111","26","85","76.5765765765766"
"f_25393","230","165","80","85","51.5151515151515"
"f_9750","797","139","55","84","60.431654676259"
"f_16452","372","163","79","84","51.5337423312883"
"f_22593","161","126","43","83","65.8730158730159"
"f_9504","1300","144","61","83","57.6388888888889"
"f_36703","111","84","2","82","97.6190476190476"
"f_20893","242","102","20","82","80.3921568627451"
"f_17932","277","133","51","82","61.6541353383459"
"f_8863","695","156","75","81","51.9230769230769"
"f_25683","220","145","65","80","55.1724137931034"
"f_10398","377","104","25","79","75.9615384615385"
"f_29763","166","150","71","79","52.6666666666667"
"f_21423","85","77","0","77","100"
"f_10015","310","93","16","77","82.7956989247312"
"f_21633","184","136","59","77","56.6176470588235"
"f_42471","150","143","66","77","53.8461538461538"
"f_28573","89","77","1","76","98.7012987012987"
"f_17052","1162","116","40","76","65.5172413793103"
"f_31143","154","144","68","76","52.7777777777778"
"f_8359","889","75","0","75","100"
"f_9569","348","114","39","75","65.7894736842105"
"j_1692","299","74","0","74","100"
"v_4072","394","74","0","74","100"
"f_21943","235","93","19","74","79.5698924731183"
"f_40743","102","99","25","74","74.7474747474747"
"f_17812","119","100","26","74","74"
"f_29693","262","144","70","74","51.3888888888889"
"f_12672","109","78","5","73","93.5897435897436"
"f_23643","144","103","30","73","70.873786407767"
"f_33113","153","81","9","72","88.8888888888889"
"f_15532","340","119","47","72","60.5042016806723"
"j_52","91","74","3","71","95.9459459459459"
"f_36173","91","83","12","71","85.5421686746988"
"f_8258","545","70","0","70","100"
"j_7973","127","78","8","70","89.7435897435897"
"f_43472","218","136","66","70","51.4705882352941"
"f_9171","204","70","1","69","98.5714285714286"
"f_24953","1060","92","23","69","75"
"a_4063","307","134","65","69","51.4925373134328"
"v_519","112","72","4","68","94.4444444444444"
"j_11803","140","103","35","68","66.0194174757282"
"v_2032","121","103","35","68","66.0194174757282"
"f_23983","467","67","0","67","100"
"f_39483","108","67","0","67","100"
"f_16492","171","80","13","67","83.75"
"f_16002","223","95","28","67","70.5263157894737"
"f_28673","196","121","54","67","55.3719008264463"
"j_6043","388","87","21","66","75.8620689655172"
"f_13262","158","88","22","66","75"
"j_12471","241","96","30","66","68.75"
"j_7183","202","104","38","66","63.4615384615385"
"v_10281","354","128","62","66","51.5625"
"a_5803","100","72","7","65","90.2777777777778"
"a_6323","824","90","25","65","72.2222222222222"
"j_5843","196","98","33","65","66.3265306122449"
"f_19193","285","114","49","65","57.0175438596491"
"f_9935","456","116","51","65","56.0344827586207"
"f_9139","554","68","4","64","94.1176470588235"
"f_12322","133","69","5","64","92.7536231884058"
"f_15402","214","70","6","64","91.4285714285714"
"f_8318","614","66","3","63","95.4545454545455"
"j_3122","103","79","16","63","79.746835443038"
"j_6353","85","84","21","63","75"
"f_46962","97","95","32","63","66.3157894736842"
"f_31283","98","96","33","63","65.625"
"f_28443","125","118","55","63","53.3898305084746"
"j_962","492","63","1","62","98.4126984126984"
"f_41541","322","94","32","62","65.9574468085106"
"f_33883","205","95","33","62","65.2631578947368"
"f_28893","159","61","0","61","100"
"f_9903","397","62","1","61","98.3870967741935"
"f_14742","411","63","2","61","96.8253968253968"
"f_8048","398","83","22","61","73.4939759036145"
"a_518","799","96","35","61","63.5416666666667"
"f_8202","565","64","4","60","93.75"
"v_1302","106","68","8","60","88.2352941176471"
"f_23673","108","86","26","60","69.7674418604651"
"f_42651","91","60","1","59","98.3333333333333"
"j_9831","75","60","1","59","98.3333333333333"
"f_15912","605","71","12","59","83.0985915492958"
"f_18943","201","93","34","59","63.4408602150538"
"j_6393","498","107","48","59","55.1401869158879"
"a_4673","277","86","28","58","67.4418604651163"
"j_15832","115","92","34","58","63.0434782608696"
"j_11591","105","99","41","58","58.5858585858586"
"f_50352","119","113","55","58","51.3274336283186"
"f_10650","347","57","0","57","100"
"f_28613","108","67","10","57","85.0746268656716"
"j_6943","99","69","12","57","82.6086956521739"
"f_26703","113","91","34","57","62.6373626373626"
"f_17422","288","98","41","57","58.1632653061224"
"f_9679","637","82","26","56","68.2926829268293"
"f_40593","97","87","31","56","64.367816091954"
"f_8996","355","55","0","55","100"
"a_4893","141","58","3","55","94.8275862068966"
"f_28663","98","63","8","55","87.3015873015873"
"f_9711","411","55","1","54","98.1818181818182"
"f_24623","83","58","4","54","93.1034482758621"
"f_24483","241","75","21","54","72"
"j_13713","86","79","25","54","68.3544303797468"
"j_9743","145","86","32","54","62.7906976744186"
"f_9443","261","98","44","54","55.1020408163265"
"a_1662","133","104","50","54","51.9230769230769"
"f_16042","296","55","2","53","96.3636363636364"
"f_11902","277","56","3","53","94.6428571428571"
"f_7934","1553","88","35","53","60.2272727272727"
"f_10204","171","81","29","52","64.1975308641975"
"a_9971","86","85","33","52","61.1764705882353"
"f_29943","123","93","41","52","55.9139784946237"
"j_10613","117","52","1","51","98.0769230769231"
"f_10066","514","53","2","51","96.2264150943396"
"j_6133","84","63","12","51","80.952380952381"
"f_18153","93","67","16","51","76.1194029850746"
"f_17102","145","68","17","51","75"
"f_19583","88","70","19","51","72.8571428571429"
"j_7393","139","51","1","50","98.0392156862745"
"f_8671","951","56","6","50","89.2857142857143"
"v_9363","81","59","9","50","84.7457627118644"
"a_8351","79","60","10","50","83.3333333333333"
"f_10502","472","69","19","50","72.463768115942"
"f_21213","194","71","21","50","70.4225352112676"
"f_8299","337","86","36","50","58.1395348837209"
"j_38","356","89","39","50","56.1797752808989"
"f_10376","276","49","0","49","100"
"f_38783","61","56","7","49","87.5"
"a_490","145","59","10","49","83.0508474576271"
"f_7887","675","62","13","49","79.0322580645161"
"f_33761","158","73","24","49","67.1232876712329"
"f_44162","79","76","27","49","64.4736842105263"
"a_11961","97","79","30","49","62.0253164556962"
"f_17362","144","48","0","48","100"
"f_36811","61","48","0","48","100"
"f_9847","353","66","18","48","72.7272727272727"
"j_10623","89","84","36","48","57.1428571428571"
"f_24353","78","52","5","47","90.3846153846154"
"j_6313","97","52","5","47","90.3846153846154"
"f_23803","102","53","6","47","88.6792452830189"
"v_7363","809","58","11","47","81.0344827586207"
"j_517","138","73","26","47","64.3835616438356"
"a_5443","215","77","30","47","61.038961038961"
"f_10112","248","46","0","46","100"
"j_6383","67","50","4","46","92"
"f_22433","721","58","12","46","79.3103448275862"
"f_8789","576","65","19","46","70.7692307692308"
"f_10144","523","78","32","46","58.974358974359"
"f_8294","4119","55","10","45","81.8181818181818"
"f_10074","273","56","11","45","80.3571428571429"
"f_8564","169","58","13","45","77.5862068965517"
"a_2622","353","46","2","44","95.6521739130435"
"a_6733","98","46","2","44","95.6521739130435"
"f_9300","259","50","6","44","88"
"f_42661","61","56","12","44","78.5714285714286"
"f_13302","371","61","17","44","72.1311475409836"
"f_32291","165","65","21","44","67.6923076923077"
"f_25951","95","66","22","44","66.6666666666667"
"f_17802","123","75","31","44","58.6666666666667"
"a_9453","78","77","33","44","57.1428571428571"
"f_21433","124","54","11","43","79.6296296296296"
"f_32163","114","74","31","43","58.1081081081081"
"v_15162","79","77","34","43","55.8441558441558"
"f_12272","1247","44","2","42","95.4545454545455"
"a_4663","112","51","9","42","82.3529411764706"
"j_9963","124","74","32","42","56.7567567567568"
"f_10142","772","41","0","41","100"
"v_9973","222","42","1","41","97.6190476190476"
"f_9289","202","44","3","41","93.1818181818182"
"f_45102","68","46","5","41","89.1304347826087"
"j_3602","174","48","7","41","85.4166666666667"
"a_8091","128","50","9","41","82"
"f_41903","473","77","36","41","53.2467532467532"
"f_8474","799","40","0","40","100"
"j_8193","66","41","1","40","97.5609756097561"
"f_8726","96","42","2","40","95.2380952380952"
"f_45402","52","50","10","40","80"
"j_10543","51","50","10","40","80"
"f_9434","778","54","14","40","74.0740740740741"
"f_35463","114","55","15","40","72.7272727272727"
"f_32031","253","66","26","40","60.6060606060606"
"f_9779","4475","67","27","40","59.7014925373134"
"f_37841","154","43","4","39","90.6976744186047"
"f_23033","225","48","9","39","81.25"
"f_10506","147","58","19","39","67.2413793103448"
"a_3322","77","59","20","39","66.1016949152542"
"j_14321","61","59","20","39","66.1016949152542"
"f_29423","173","71","32","39","54.9295774647887"
"f_8849","553","39","1","38","97.4358974358974"
"f_40811","99","42","4","38","90.4761904761905"
"f_8198","294","49","11","38","77.5510204081633"
"f_9815","197","52","14","38","73.0769230769231"
"f_8893","2752","55","17","38","69.0909090909091"
"j_11501","66","61","23","38","62.2950819672131"
"f_19873","85","68","30","38","55.8823529411765"
"f_22373","143","69","31","38","55.0724637681159"
"a_6863","261","38","1","37","97.3684210526316"
"f_34791","108","38","1","37","97.3684210526316"
"f_8603","1013","38","1","37","97.3684210526316"
"f_33633","275","39","2","37","94.8717948717949"
"f_43492","102","49","12","37","75.5102040816327"
"f_28243","95","55","18","37","67.2727272727273"
"f_42062","116","69","32","37","53.6231884057971"
"a_554","330","36","0","36","100"
"f_13482","448","37","1","36","97.2972972972973"
"f_9835","384","37","1","36","97.2972972972973"
"f_8250","196","39","3","36","92.3076923076923"
"f_8073","344","42","6","36","85.7142857142857"
"j_6883","194","42","6","36","85.7142857142857"
"f_22653","715","44","8","36","81.8181818181818"
"f_17122","200","53","17","36","67.9245283018868"
"f_10152","552","55","19","36","65.4545454545455"
"j_293","417","56","20","36","64.2857142857143"
"f_33001","328","69","33","36","52.1739130434783"
"f_10822","103","35","0","35","100"
"f_21613","256","36","1","35","97.2222222222222"
"f_29383","47","37","2","35","94.5945945945946"
"j_2352","68","39","4","35","89.7435897435897"
"f_31623","42","40","5","35","87.5"
"f_10122","103","41","6","35","85.3658536585366"
"f_9804","183","43","8","35","81.3953488372093"
"f_27543","105","47","12","35","74.468085106383"
"f_7949","215","51","16","35","68.6274509803922"
"f_7844","308","35","1","34","97.1428571428571"
"j_5113","218","39","5","34","87.1794871794872"
"f_29643","119","53","19","34","64.1509433962264"
"f_10310","120","57","23","34","59.6491228070175"
"f_21233","403","61","27","34","55.7377049180328"
"f_9460","637","33","0","33","100"
"j_2192","242","33","0","33","100"
"f_10806","593","43","10","33","76.7441860465116"
"f_7867","482","47","14","33","70.2127659574468"
"v_16061","66","48","15","33","68.75"
"f_18923","168","60","27","33","55"
"v_1672","877","63","30","33","52.3809523809524"
"f_33243","91","64","31","33","51.5625"
"a_10882","41","32","0","32","100"
"j_11051","63","32","0","32","100"
"f_9318","493","35","3","32","91.4285714285714"
"f_12952","68","36","4","32","88.8888888888889"
"j_11813","824","36","4","32","88.8888888888889"
"f_7903","244","38","6","32","84.2105263157895"
"v_3172","274","38","6","32","84.2105263157895"
"f_38673","39","39","7","32","82.0512820512821"
"j_7283","52","39","7","32","82.0512820512821"
"f_34413","359","41","9","32","78.0487804878049"
"f_8138","357","51","19","32","62.7450980392157"
"f_32281","233","56","24","32","57.1428571428571"
"f_8817","616","31","0","31","100"
"f_9848","385","31","0","31","100"
"v_284","838","31","0","31","100"
"j_11843","1105","33","2","31","93.9393939393939"
"j_12123","71","33","2","31","93.9393939393939"
"j_4723","207","37","6","31","83.7837837837838"
"f_8827","472","43","12","31","72.093023255814"
"f_13742","327","44","13","31","70.4545454545455"
"f_48602","330","52","21","31","59.6153846153846"
"f_10442","33","30","0","30","100"
"a_10403","45","35","5","30","85.7142857142857"
"f_30883","39","36","6","30","83.3333333333333"
"f_9283","834","44","14","30","68.1818181818182"
"a_2152","180","50","20","30","60"
"f_24233","895","53","23","30","56.6037735849057"
"f_46412","57","54","24","30","55.5555555555556"
"j_8543","37","30","1","29","96.6666666666667"
"v_9303","99","33","4","29","87.8787878787879"
"v_14022","163","39","10","29","74.3589743589744"
"v_204","868","44","15","29","65.9090909090909"
"a_10031","49","48","19","29","60.4166666666667"
"j_13331","58","54","25","29","53.7037037037037"
"f_25863","179","28","0","28","100"
"f_22933","452","33","5","28","84.8484848484848"
"f_25233","173","36","8","28","77.7777777777778"
"a_12452","118","38","10","28","73.6842105263158"
"f_36663","95","41","13","28","68.2926829268293"
"a_141","471","46","18","28","60.8695652173913"
"j_9671","61","54","26","28","51.8518518518519"
"a_180","435","27","0","27","100"
"j_326","282","27","0","27","100"
"j_485","81","27","0","27","100"
"j_94","470","28","1","27","96.4285714285714"
"f_33021","166","29","2","27","93.1034482758621"
"v_1502","179","32","5","27","84.375"
"j_6723","65","35","8","27","77.1428571428571"
"f_8910","165","41","14","27","65.8536585365854"
"f_9341","1619","41","14","27","65.8536585365854"
"j_13451","77","46","19","27","58.695652173913"
"j_9871","65","48","21","27","56.25"
"f_8633","154","51","24","27","52.9411764705882"
"f_18063","58","27","1","26","96.2962962962963"
"a_3963","32","30","4","26","86.6666666666667"
"f_25273","159","31","5","26","83.8709677419355"
"f_37573","80","32","6","26","81.25"
"f_12512","239","33","7","26","78.7878787878788"
"v_9263","73","33","7","26","78.7878787878788"
"f_37811","67","34","8","26","76.4705882352941"
"f_39243","53","40","14","26","65"
"f_41713","44","42","16","26","61.9047619047619"
"j_202","275","25","0","25","100"
"f_10132","557","26","1","25","96.1538461538462"
"f_21983","271","26","1","25","96.1538461538462"
"a_7383","566","28","3","25","89.2857142857143"
"v_47","467","29","4","25","86.2068965517241"
"f_13012","41","30","5","25","83.3333333333333"
"f_30453","44","30","5","25","83.3333333333333"
"f_8718","1314","30","5","25","83.3333333333333"
"a_4953","206","31","6","25","80.6451612903226"
"a_1912","310","33","8","25","75.7575757575758"
"j_6373","430","36","11","25","69.4444444444444"
"a_6383","405","37","12","25","67.5675675675676"
"v_6531","503","41","16","25","60.9756097560976"
"f_30933","52","42","17","25","59.5238095238095"
"j_10471","62","47","22","25","53.1914893617021"
"a_9881","69","25","1","24","96"
"f_25923","626","25","1","24","96"
"f_8464","301","26","2","24","92.3076923076923"
"f_9412","271","28","4","24","85.7142857142857"
"f_9784","83","28","4","24","85.7142857142857"
"j_4763","72","28","4","24","85.7142857142857"
"f_8002","351","29","5","24","82.7586206896552"
"f_9512","1606","31","7","24","77.4193548387097"
"f_25843","49","32","8","24","75"
"j_13031","32","24","1","23","95.8333333333333"
"f_13912","173","26","3","23","88.4615384615385"
"j_10163","33","26","3","23","88.4615384615385"
"v_4683","426","26","3","23","88.4615384615385"
"f_19433","572","27","4","23","85.1851851851852"
"f_37563","37","27","4","23","85.1851851851852"
"f_14322","158","30","7","23","76.6666666666667"
"f_18853","96","31","8","23","74.1935483870968"
"f_7935","1207","32","9","23","71.875"
"j_9533","54","33","10","23","69.6969696969697"
"j_9753","61","34","11","23","67.6470588235294"
"a_2352","618","36","13","23","63.8888888888889"
"f_13692","688","43","20","23","53.4883720930233"
"j_14472","46","45","22","23","51.1111111111111"
"f_9514","676","22","0","22","100"
"j_13511","29","22","0","22","100"
"j_15","456","22","0","22","100"
"j_391","116","23","1","22","95.6521739130435"
"f_30233","205","24","2","22","91.6666666666667"
"f_9329","132","24","2","22","91.6666666666667"
"a_2612","246","25","3","22","88"
"a_7413","54","32","10","22","68.75"
"f_17002","127","33","11","22","66.6666666666667"
"f_10646","373","34","12","22","64.7058823529412"
"f_45681","99","34","12","22","64.7058823529412"
"f_18773","74","39","17","22","56.4102564102564"
"j_9211","72","43","21","22","51.1627906976744"
"f_10404","155","22","1","21","95.4545454545455"
"f_31753","129","23","2","21","91.304347826087"
"a_5413","471","24","3","21","87.5"
"j_5193","1811","24","3","21","87.5"
"v_1862","1202","27","6","21","77.7777777777778"
"f_30633","38","33","12","21","63.6363636363636"
"f_27813","48","40","19","21","52.5"
"f_35823","44","40","19","21","52.5"
"j_11041","27","20","0","20","100"
"j_11913","155","20","0","20","100"
"j_4563","248","20","0","20","100"
"f_9503","129","21","1","20","95.2380952380952"
"v_45","461","22","2","20","90.9090909090909"
"a_5513","1361","26","6","20","76.9230769230769"
"v_730","525","32","12","20","62.5"
"f_34393","69","35","15","20","57.1428571428571"
"j_13921","62","35","15","20","57.1428571428571"
"j_15292","36","36","16","20","55.5555555555556"
"f_48051","86","37","17","20","54.0540540540541"
"f_9506","953","21","2","19","90.4761904761905"
"f_9757","604","21","2","19","90.4761904761905"
"f_33493","283","22","3","19","86.3636363636364"
"j_10153","76","22","3","19","86.3636363636364"
"f_8874","108","24","5","19","79.1666666666667"
"f_8975","386","26","7","19","73.0769230769231"
"j_192","182","26","7","19","73.0769230769231"
"j_3412","47","26","7","19","73.0769230769231"
"f_9113","206","27","8","19","70.3703703703704"
"f_32011","32","29","10","19","65.5172413793103"
"f_20163","52","31","12","19","61.2903225806452"
"j_16172","33","32","13","19","59.375"
"j_13791","35","34","15","19","55.8823529411765"
"f_45312","134","35","16","19","54.2857142857143"
"v_6521","129","37","18","19","51.3513513513514"
"f_15572","112","18","0","18","100"
"f_20123","35","18","0","18","100"
"f_9858","273","18","0","18","100"
"j_404","191","18","0","18","100"
"j_6863","67","18","0","18","100"
"v_81","713","18","0","18","100"
"f_10672","110","19","1","18","94.7368421052632"
"f_13542","232","19","1","18","94.7368421052632"
"f_49312","35","19","1","18","94.7368421052632"
"v_1032","818","19","1","18","94.7368421052632"
"f_16892","63","21","3","18","85.7142857142857"
"f_17752","407","21","3","18","85.7142857142857"
"f_8972","131","21","3","18","85.7142857142857"
"j_9113","122","21","3","18","85.7142857142857"
"f_36523","382","22","4","18","81.8181818181818"
"f_29273","187","23","5","18","78.2608695652174"
"f_42361","66","25","7","18","72"
"j_10303","53","25","7","18","72"
"v_662","2989","28","10","18","64.2857142857143"
"f_40333","114","30","12","18","60"
"f_31323","39","35","17","18","51.4285714285714"
"a_12072","54","17","0","17","100"
"f_8272","1979","17","0","17","100"
"f_16192","165","18","1","17","94.4444444444444"
"j_8223","31","18","1","17","94.4444444444444"
"f_7947","703","19","2","17","89.4736842105263"
"f_8868","248","19","2","17","89.4736842105263"
"f_9591","437","19","2","17","89.4736842105263"
"j_6143","82","19","2","17","89.4736842105263"
"f_12692","274","20","3","17","85"
"f_22083","40","22","5","17","77.2727272727273"
"f_33303","58","22","5","17","77.2727272727273"
"j_6893","150","22","5","17","77.2727272727273"
"v_4303","36","23","6","17","73.9130434782609"
"f_10766","371","25","8","17","68"
"f_24393","148","25","8","17","68"
"f_18653","118","26","9","17","65.3846153846154"
"f_9402","824","28","11","17","60.7142857142857"
"a_10742","40","33","16","17","51.5151515151515"
"f_13782","296","16","0","16","100"
"f_21023","396","16","0","16","100"
"f_27153","1142","16","0","16","100"
"f_27243","388","16","0","16","100"
"f_30143","80","16","0","16","100"
"f_8791","176","16","0","16","100"
"f_9614","236","16","0","16","100"
"j_11413","47","16","0","16","100"
"j_14241","232","16","0","16","100"
"v_6953","1346","16","0","16","100"
"f_12092","576","17","1","16","94.1176470588235"
"f_34491","84","17","1","16","94.1176470588235"
"f_8595","922","17","1","16","94.1176470588235"
"f_18603","157","19","3","16","84.2105263157895"
"f_8482","601","19","3","16","84.2105263157895"
"a_6173","189","20","4","16","80"
"f_20323","103","24","8","16","66.6666666666667"
"f_43671","30","24","8","16","66.6666666666667"
"f_38773","41","25","9","16","64"
"f_26123","89","26","10","16","61.5384615384615"
"f_36621","270","31","15","16","51.6129032258065"
"a_12392","37","15","0","15","100"
"f_15212","326","15","0","15","100"
"f_19543","176","15","0","15","100"
"f_23943","480","15","0","15","100"
"f_9218","4398","15","0","15","100"
"f_9573","249","15","0","15","100"
"j_922","19","15","0","15","100"
"f_10572","254","16","1","15","93.75"
"f_48731","67","16","1","15","93.75"
"f_8303","139","16","1","15","93.75"
"f_8869","147","16","1","15","93.75"
"f_9301","333","16","1","15","93.75"
"f_9755","61","16","1","15","93.75"
"f_15552","1260","17","2","15","88.2352941176471"
"f_8837","2223","17","2","15","88.2352941176471"
"j_6263","64","17","2","15","88.2352941176471"
"f_24553","32","18","3","15","83.3333333333333"
"f_25483","137","18","3","15","83.3333333333333"
"f_25473","63","19","4","15","78.9473684210526"
"a_5283","269","20","5","15","75"
"f_15012","153","20","5","15","75"
"f_18863","138","22","7","15","68.1818181818182"
"f_24663","129","22","7","15","68.1818181818182"
"a_9771","110","23","8","15","65.2173913043478"
"f_10060","225","23","8","15","65.2173913043478"
"j_14462","32","23","8","15","65.2173913043478"
"f_20233","190","24","9","15","62.5"
"f_36371","29","25","10","15","60"
"f_20153","193","28","13","15","53.5714285714286"
"f_38231","139","28","13","15","53.5714285714286"
"f_30173","43","29","14","15","51.7241379310345"
"f_32351","37","14","0","14","100"
"f_33643","71","14","0","14","100"
"f_8301","359","14","0","14","100"
"f_8850","120","14","0","14","100"
"j_2122","530","14","0","14","100"
"v_3542","343","14","0","14","100"
"f_14202","141","15","1","14","93.3333333333333"
"f_8648","762","15","1","14","93.3333333333333"
"j_9323","2474","15","1","14","93.3333333333333"
"f_25913","18","16","2","14","87.5"
"f_16162","154","17","3","14","82.3529411764706"
"j_219","85","17","3","14","82.3529411764706"
"f_21003","148","19","5","14","73.6842105263158"
"f_42562","130","19","5","14","73.6842105263158"
"f_29173","120","20","6","14","70"
"j_15052","47","20","6","14","70"
"f_19563","177","21","7","14","66.6666666666667"
"j_8873","90","22","8","14","63.6363636363636"
"f_26363","95","23","9","14","60.8695652173913"
"f_29513","632","24","10","14","58.3333333333333"
"f_20453","225","27","13","14","51.8518518518519"
"a_12631","82","13","0","13","100"
"f_15692","201","13","0","13","100"
"f_31453","52","13","0","13","100"
"f_8463","148","13","0","13","100"
"f_8623","1847","13","0","13","100"
"f_9235","135","13","0","13","100"
"j_13862","45","13","0","13","100"
"j_1932","360","13","0","13","100"
"f_10516","225","14","1","13","92.8571428571429"
"f_27883","810","14","1","13","92.8571428571429"
"f_28993","40","14","1","13","92.8571428571429"
"f_9327","104","14","1","13","92.8571428571429"
"j_5963","162","14","1","13","92.8571428571429"
"a_11491","16","15","2","13","86.6666666666667"
"f_18933","143","15","2","13","86.6666666666667"
"f_8481","189","15","2","13","86.6666666666667"
"f_9224","793","15","2","13","86.6666666666667"
"f_9971","168","15","2","13","86.6666666666667"
"j_10523","257","15","2","13","86.6666666666667"
"j_4443","236","15","2","13","86.6666666666667"
"f_15602","675","17","4","13","76.4705882352941"
"f_39403","161","17","4","13","76.4705882352941"
"f_23473","135","18","5","13","72.2222222222222"
"j_12063","29","18","5","13","72.2222222222222"
"j_9091","36","19","6","13","68.4210526315789"
"f_38131","81","22","9","13","59.0909090909091"
"f_16712","181","23","10","13","56.5217391304348"
"f_15392","71","24","11","13","54.1666666666667"
"f_26973","31","24","11","13","54.1666666666667"
"f_33203","28","25","12","13","52"
"a_291","1242","12","0","12","100"
"f_13792","374","12","0","12","100"
"f_17982","216","12","0","12","100"
"f_18483","596","12","0","12","100"
"f_22723","26","12","0","12","100"
"f_28073","86","12","0","12","100"
"f_8665","344","12","0","12","100"
"f_9338","139","12","0","12","100"
"j_15551","34","12","0","12","100"
"f_13842","123","13","1","12","92.3076923076923"
"f_14442","460","13","1","12","92.3076923076923"
"f_15032","263","13","1","12","92.3076923076923"
"j_11361","43","13","1","12","92.3076923076923"
"f_13902","124","14","2","12","85.7142857142857"
"f_25383","497","14","2","12","85.7142857142857"
"f_29433","182","14","2","12","85.7142857142857"
"f_46751","58","15","3","12","80"
"f_10812","69","16","4","12","75"
"f_23603","114","16","4","12","75"
"f_26223","57","17","5","12","70.5882352941176"
"j_6623","116","17","5","12","70.5882352941176"
"a_10193","22","18","6","12","66.6666666666667"
"a_4463","85","18","6","12","66.6666666666667"
"a_6633","78","18","6","12","66.6666666666667"
"f_15802","75","20","8","12","60"
"f_23493","228","21","9","12","57.1428571428571"
"f_48011","29","21","9","12","57.1428571428571"
"f_8691","828","21","9","12","57.1428571428571"
"f_15542","46","22","10","12","54.5454545454545"
"f_8778","225","22","10","12","54.5454545454545"
"j_10743","412","22","10","12","54.5454545454545"
"j_14752","33","22","10","12","54.5454545454545"
"j_9101","45","22","10","12","54.5454545454545"
"f_31363","74","23","11","12","52.1739130434783"
"a_3623","334","11","0","11","100"
"f_22423","37","11","0","11","100"
"f_38323","14","11","0","11","100"
"f_8664","119","11","0","11","100"
"f_9186","1144","11","0","11","100"
"f_9205","104","11","0","11","100"
"f_9680","288","11","0","11","100"
"f_9722","262","11","0","11","100"
"f_9949","200","11","0","11","100"
"f_9997","138","11","0","11","100"
"j_13941","353","11","0","11","100"
"j_1452","300","11","0","11","100"
"j_6493","66","11","0","11","100"
"f_17472","190","12","1","11","91.6666666666667"
"f_8518","371","12","1","11","91.6666666666667"
"f_16882","41","13","2","11","84.6153846153846"
"a_3723","102","14","3","11","78.5714285714286"
"f_11832","106","14","3","11","78.5714285714286"
"f_16282","33","14","3","11","78.5714285714286"
"f_9256","612","14","3","11","78.5714285714286"
"f_12292","116","15","4","11","73.3333333333333"
"f_20373","68","15","4","11","73.3333333333333"
"j_10793","45","16","5","11","68.75"
"f_8984","242","17","6","11","64.7058823529412"
"a_540","231","18","7","11","61.1111111111111"
"f_9458","150","18","7","11","61.1111111111111"
"j_11681","211","18","7","11","61.1111111111111"
"f_28823","32","19","8","11","57.8947368421053"
"f_9881","614","20","9","11","55"
"f_46121","147","21","10","11","52.3809523809524"
"f_11942","99","10","0","10","100"
"f_7856","392","10","0","10","100"
"f_8015","307","10","0","10","100"
"f_8046","266","10","0","10","100"
"f_8320","297","10","0","10","100"
"f_8619","246","10","0","10","100"
"f_9455","274","10","0","10","100"
"f_9513","124","10","0","10","100"
"f_9526","165","10","0","10","100"
"j_14421","106","10","0","10","100"
"j_150","54","10","0","10","100"
"f_23693","607","11","1","10","90.9090909090909"
"f_25043","11","11","1","10","90.9090909090909"
"f_25663","14","11","1","10","90.9090909090909"
"f_26603","189","11","1","10","90.9090909090909"
"f_47351","65","11","1","10","90.9090909090909"
"f_9808","472","11","1","10","90.9090909090909"
"v_1332","249","11","1","10","90.9090909090909"
"f_21653","226","12","2","10","83.3333333333333"
"f_37931","71","12","2","10","83.3333333333333"
"f_9413","284","12","2","10","83.3333333333333"
"f_20343","77","14","4","10","71.4285714285714"
"f_36673","27","14","4","10","71.4285714285714"
"j_6913","223","14","4","10","71.4285714285714"
"a_4763","24","15","5","10","66.6666666666667"
"j_14942","25","16","6","10","62.5"
"f_29623","313","17","7","10","58.8235294117647"
"f_42172","18","17","7","10","58.8235294117647"
"j_10873","22","18","8","10","55.5555555555556"
"a_4883","109","19","9","10","52.6315789473684"
"f_46941","37","19","9","10","52.6315789473684"
"j_9293","708","19","9","10","52.6315789473684"
"j_9611","58","19","9","10","52.6315789473684"
"f_11052","303","9","0","9","100"
"f_11952","326","9","0","9","100"
"f_17552","667","9","0","9","100"
"f_26763","595","9","0","9","100"
"f_28113","299","9","0","9","100"
"f_29973","112","9","0","9","100"
"f_8188","905","9","0","9","100"
"f_8436","138","9","0","9","100"
"f_9611","315","9","0","9","100"
"j_230","560","9","0","9","100"
"v_14482","11","9","0","9","100"
"f_17732","74","10","1","9","90"
"f_9119","317","10","1","9","90"
"f_9310","215","10","1","9","90"
"f_9520","142","10","1","9","90"
"f_9613","641","10","1","9","90"
"j_15431","24","10","1","9","90"
"f_39871","171","11","2","9","81.8181818181818"
"f_45382","104","11","2","9","81.8181818181818"
"f_39573","101","12","3","9","75"
"f_42451","38","12","3","9","75"
"a_5893","36","13","4","9","69.2307692307692"
"f_10628","114","13","4","9","69.2307692307692"
"f_32213","74","13","4","9","69.2307692307692"
"f_38081","19","13","4","9","69.2307692307692"
"a_11512","31","14","5","9","64.2857142857143"
"a_11682","97","14","5","9","64.2857142857143"
"a_9861","93","14","5","9","64.2857142857143"
"j_5683","53","14","5","9","64.2857142857143"
"f_39163","155","16","7","9","56.25"
"v_7853","124","16","7","9","56.25"
"f_10570","524","17","8","9","52.9411764705882"
"f_35123","20","17","8","9","52.9411764705882"
"f_8308","416","17","8","9","52.9411764705882"
"f_9907","55","17","8","9","52.9411764705882"
"f_16582","457","8","0","8","100"
"f_22523","134","8","0","8","100"
"f_8248","208","8","0","8","100"
"f_8645","241","8","0","8","100"
"f_8743","415","8","0","8","100"
"f_9099","186","8","0","8","100"
"f_9198","1692","8","0","8","100"
"f_9563","1263","8","0","8","100"
"j_15922","42","8","0","8","100"
"j_364","50","8","0","8","100"
"j_7603","87","8","0","8","100"
"f_10606","537","9","1","8","88.8888888888889"
"f_24273","81","9","1","8","88.8888888888889"
"f_33823","302","9","1","8","88.8888888888889"
"f_43542","40","9","1","8","88.8888888888889"
"f_46372","9","9","1","8","88.8888888888889"
"f_7838","743","9","1","8","88.8888888888889"
"f_8911","502","9","1","8","88.8888888888889"
"v_13153","65","9","1","8","88.8888888888889"
"f_10422","293","10","2","8","80"
"f_19743","876","10","2","8","80"
"f_7978","485","10","2","8","80"
"j_13461","142","10","2","8","80"
"j_24","91","10","2","8","80"
"v_7473","186","10","2","8","80"
"j_10391","40","11","3","8","72.7272727272727"
"j_576","125","11","3","8","72.7272727272727"
"v_14941","16","11","3","8","72.7272727272727"
"f_21593","193","12","4","8","66.6666666666667"
"j_11581","100","12","4","8","66.6666666666667"
"f_21483","33","13","5","8","61.5384615384615"
"f_8184","544","13","5","8","61.5384615384615"
"f_37551","16","14","6","8","57.1428571428571"
"f_40763","145","14","6","8","57.1428571428571"
"f_7848","552","14","6","8","57.1428571428571"
"f_8243","1073","14","6","8","57.1428571428571"
"f_18002","70","15","7","8","53.3333333333333"
"j_14561","29","15","7","8","53.3333333333333"
"a_108","238","7","0","7","100"
"a_46","189","7","0","7","100"
"f_10056","119","7","0","7","100"
"f_10134","389","7","0","7","100"
"f_10236","353","7","0","7","100"
"f_14192","49","7","0","7","100"
"f_21033","66","7","0","7","100"
"f_21963","136","7","0","7","100"
"f_26803","79","7","0","7","100"
"f_28173","24","7","0","7","100"
"f_30613","33","7","0","7","100"
"f_32881","139","7","0","7","100"
"f_33071","20","7","0","7","100"
"f_50332","49","7","0","7","100"
"f_8265","65","7","0","7","100"
"f_8943","272","7","0","7","100"
"f_9303","181","7","0","7","100"
"f_9370","81","7","0","7","100"
"f_9581","201","7","0","7","100"
"f_9795","66","7","0","7","100"
"f_9856","66","7","0","7","100"
"j_12501","1195","7","0","7","100"
"j_442","373","7","0","7","100"
"j_503","374","7","0","7","100"
"j_7503","331","7","0","7","100"
"j_8093","208","7","0","7","100"
"v_538","382","7","0","7","100"
"v_5833","222","7","0","7","100"
"a_3733","409","8","1","7","87.5"
"f_10146","290","8","1","7","87.5"
"f_10408","207","8","1","7","87.5"
"f_16702","93","8","1","7","87.5"
"f_17722","207","8","1","7","87.5"
"f_24883","20","8","1","7","87.5"
"f_44692","55","8","1","7","87.5"
"f_50021","34","8","1","7","87.5"
"f_8065","240","8","1","7","87.5"
"a_3422","58","9","2","7","77.7777777777778"
"f_14882","108","9","2","7","77.7777777777778"
"f_16942","476","9","2","7","77.7777777777778"
"f_23743","363","9","2","7","77.7777777777778"
"f_25153","13","9","2","7","77.7777777777778"
"f_8208","92","9","2","7","77.7777777777778"
"f_9304","740","9","2","7","77.7777777777778"
"j_3302","302","9","2","7","77.7777777777778"
"f_45792","11","10","3","7","70"
"f_9527","232","10","3","7","70"
"f_26663","115","11","4","7","63.6363636363636"
"f_30083","146","11","4","7","63.6363636363636"
"j_5303","26","11","4","7","63.6363636363636"
"f_38911","42","12","5","7","58.3333333333333"
"f_40933","16","12","5","7","58.3333333333333"
"f_43931","16","12","5","7","58.3333333333333"
"j_13533","209","12","5","7","58.3333333333333"
"v_1312","568","12","5","7","58.3333333333333"
"f_10021","141","6","0","6","100"
"f_13282","437","6","0","6","100"
"f_13472","262","6","0","6","100"
"f_14022","78","6","0","6","100"
"f_15432","125","6","0","6","100"
"f_20983","54","6","0","6","100"
"f_25283","844","6","0","6","100"
"f_31153","252","6","0","6","100"
"f_37963","206","6","0","6","100"
"f_49042","97","6","0","6","100"
"f_50152","37","6","0","6","100"
"f_7926","351","6","0","6","100"
"f_8561","79","6","0","6","100"
"f_8866","1166","6","0","6","100"
"f_9001","121","6","0","6","100"
"f_9595","335","6","0","6","100"
"f_9601","22","6","0","6","100"
"f_9715","1208","6","0","6","100"
"f_9851","103","6","0","6","100"
"j_8033","94","6","0","6","100"
"v_261","725","6","0","6","100"
"v_8473","612","6","0","6","100"
"a_10023","10","7","1","6","85.7142857142857"
"f_36713","17","7","1","6","85.7142857142857"
"f_44321","7","7","1","6","85.7142857142857"
"f_7948","440","7","1","6","85.7142857142857"
"f_8128","839","7","1","6","85.7142857142857"
"j_11961","580","7","1","6","85.7142857142857"
"j_210","384","7","1","6","85.7142857142857"
"j_6413","97","7","1","6","85.7142857142857"
"v_400","1076","7","1","6","85.7142857142857"
"f_37641","19","8","2","6","75"
"f_42782","38","8","2","6","75"
"f_46302","9","8","2","6","75"
"f_8178","636","8","2","6","75"
"f_8819","425","8","2","6","75"
"f_9127","185","8","2","6","75"
"v_449","220","8","2","6","75"
"f_11522","514","9","3","6","66.6666666666667"
"f_15462","378","9","3","6","66.6666666666667"
"f_18053","213","9","3","6","66.6666666666667"
"f_18163","102","9","3","6","66.6666666666667"
"f_26051","983","9","3","6","66.6666666666667"
"f_33383","31","9","3","6","66.6666666666667"
"a_5083","182","10","4","6","60"
"f_27413","22","10","4","6","60"
"f_41531","74","10","4","6","60"
"f_9451","550","10","4","6","60"
"j_590","441","10","4","6","60"
"j_9523","113","10","4","6","60"
"f_29813","211","11","5","6","54.5454545454545"
"f_43151","49","11","5","6","54.5454545454545"
"f_44361","46","11","5","6","54.5454545454545"
"f_8909","296","11","5","6","54.5454545454545"
"f_10084","289","5","0","5","100"
"f_10716","209","5","0","5","100"
"f_14262","43","5","0","5","100"
"f_17672","220","5","0","5","100"
"f_19063","90","5","0","5","100"
"f_20053","244","5","0","5","100"
"f_24033","228","5","0","5","100"
"f_32981","169","5","0","5","100"
"f_33751","84","5","0","5","100"
"f_37013","32","5","0","5","100"
"f_39343","140","5","0","5","100"
"f_42351","159","5","0","5","100"
"f_48001","81","5","0","5","100"
"f_48432","61","5","0","5","100"
"f_8367","1083","5","0","5","100"
"f_8419","1473","5","0","5","100"
"f_8629","325","5","0","5","100"
"f_8698","433","5","0","5","100"
"f_8764","1624","5","0","5","100"
"f_8945","112","5","0","5","100"
"f_9227","115","5","0","5","100"
"j_242","29","5","0","5","100"
"j_2782","208","5","0","5","100"
"j_288","1986","5","0","5","100"
"j_495","253","5","0","5","100"
"j_9221","155","5","0","5","100"
"j_9393","442","5","0","5","100"
"v_2452","73","5","0","5","100"
"v_3672","7","5","0","5","100"
"v_4062","810","5","0","5","100"
"v_4703","48","5","0","5","100"
"a_12431","313","6","1","5","83.3333333333333"
"a_177","156","6","1","5","83.3333333333333"
"a_7803","232","6","1","5","83.3333333333333"
"f_18223","580","6","1","5","83.3333333333333"
"f_18403","125","6","1","5","83.3333333333333"
"f_23593","75","6","1","5","83.3333333333333"
"f_23903","57","6","1","5","83.3333333333333"
"f_27473","31","6","1","5","83.3333333333333"
"f_46162","67","6","1","5","83.3333333333333"
"f_50201","51","6","1","5","83.3333333333333"
"f_8639","822","6","1","5","83.3333333333333"
"f_9494","216","6","1","5","83.3333333333333"
"j_12481","710","6","1","5","83.3333333333333"
"a_3312","129","7","2","5","71.4285714285714"
"a_3673","449","7","2","5","71.4285714285714"
"a_4313","46","7","2","5","71.4285714285714"
"f_17192","385","7","2","5","71.4285714285714"
"f_31871","14","7","2","5","71.4285714285714"
"f_38453","10","7","2","5","71.4285714285714"
"f_44062","46","7","2","5","71.4285714285714"
"j_11721","17","7","2","5","71.4285714285714"
"j_12391","38","7","2","5","71.4285714285714"
"f_18463","224","8","3","5","62.5"
"f_44822","58","8","3","5","62.5"
"f_8331","494","8","3","5","62.5"
"f_8753","415","8","3","5","62.5"
"f_8867","52","8","3","5","62.5"
"j_13822","72","8","3","5","62.5"
"a_59","133","9","4","5","55.5555555555556"
"f_17962","658","9","4","5","55.5555555555556"
"f_26543","48","9","4","5","55.5555555555556"
"f_32653","10","9","4","5","55.5555555555556"
"f_43901","38","9","4","5","55.5555555555556"
"f_7988","362","9","4","5","55.5555555555556"
"f_9293","131","9","4","5","55.5555555555556"
"j_13742","54","9","4","5","55.5555555555556"
"a_29","1346","4","0","4","100"
"a_3883","507","4","0","4","100"
"a_4383","77","4","0","4","100"
"f_10620","121","4","0","4","100"
"f_11492","248","4","0","4","100"
"f_14402","221","4","0","4","100"
"f_17412","453","4","0","4","100"
"f_20273","177","4","0","4","100"
"f_23353","107","4","0","4","100"
"f_26001","316","4","0","4","100"
"f_27113","59","4","0","4","100"
"f_29613","118","4","0","4","100"
"f_40741","483","4","0","4","100"
"f_43681","20","4","0","4","100"
"f_44382","26","4","0","4","100"
"f_49112","157","4","0","4","100"
"f_8363","364","4","0","4","100"
"f_8432","470","4","0","4","100"
"f_8602","51","4","0","4","100"
"f_8626","425","4","0","4","100"
"f_8788","195","4","0","4","100"
"f_8872","1413","4","0","4","100"
"f_9028","122","4","0","4","100"
"f_9071","80","4","0","4","100"
"f_9073","104","4","0","4","100"
"f_9333","186","4","0","4","100"
"f_9378","356","4","0","4","100"
"f_9380","438","4","0","4","100"
"f_9495","117","4","0","4","100"
"f_9529","188","4","0","4","100"
"j_16622","119","4","0","4","100"
"j_214","487","4","0","4","100"
"j_2312","10","4","0","4","100"
"j_380","270","4","0","4","100"
"j_4333","31","4","0","4","100"
"j_5553","188","4","0","4","100"
"j_8263","14","4","0","4","100"
"j_9713","301","4","0","4","100"
"j_9933","27","4","0","4","100"
"v_12683","44","4","0","4","100"
"v_2232","1238","4","0","4","100"
"f_10698","900","5","1","4","80"
"f_15322","90","5","1","4","80"
"f_21383","180","5","1","4","80"
"f_22763","118","5","1","4","80"
"f_24333","64","5","1","4","80"
"f_47082","29","5","1","4","80"
"f_47761","55","5","1","4","80"
"f_48162","54","5","1","4","80"
"f_7815","316","5","1","4","80"
"f_8254","397","5","1","4","80"
"f_8356","105","5","1","4","80"
"f_8437","206","5","1","4","80"
"f_9349","73","5","1","4","80"
"j_11731","623","5","1","4","80"
"j_415","347","5","1","4","80"
"j_610","401","5","1","4","80"
"v_5293","49","5","1","4","80"
"a_1562","179","6","2","4","66.6666666666667"
"f_10276","12","6","2","4","66.6666666666667"
"f_10388","233","6","2","4","66.6666666666667"
"f_24833","419","6","2","4","66.6666666666667"
"f_29163","335","6","2","4","66.6666666666667"
"f_35981","11","6","2","4","66.6666666666667"
"f_42792","39","6","2","4","66.6666666666667"
"f_8714","331","6","2","4","66.6666666666667"
"f_8813","116","6","2","4","66.6666666666667"
"j_193","186","6","2","4","66.6666666666667"
"j_4","58","6","2","4","66.6666666666667"
"j_6503","583","6","2","4","66.6666666666667"
"j_9463","25","6","2","4","66.6666666666667"
"j_9493","104","6","2","4","66.6666666666667"
"v_259","1459","6","2","4","66.6666666666667"
"a_6033","153","7","3","4","57.1428571428571"
"f_17972","45","7","3","4","57.1428571428571"
"f_23483","155","7","3","4","57.1428571428571"
"f_27143","146","7","3","4","57.1428571428571"
"f_28143","86","7","3","4","57.1428571428571"
"f_37701","16","7","3","4","57.1428571428571"
"f_41681","8","7","3","4","57.1428571428571"
"f_8958","75","7","3","4","57.1428571428571"
"f_9862","286","7","3","4","57.1428571428571"
"j_5703","17","7","3","4","57.1428571428571"
"a_10051","37","3","0","3","100"
"a_11191","51","3","0","3","100"
"a_11962","157","3","0","3","100"
"a_2642","56","3","0","3","100"
"a_302","37","3","0","3","100"
"a_3433","75","3","0","3","100"
"a_4103","257","3","0","3","100"
"a_5733","218","3","0","3","100"
"f_10082","44","3","0","3","100"
"f_10114","140","3","0","3","100"
"f_10316","202","3","0","3","100"
"f_10328","2056","3","0","3","100"
"f_10402","58","3","0","3","100"
"f_10568","190","3","0","3","100"
"f_11402","84","3","0","3","100"
"f_12362","302","3","0","3","100"
"f_12372","67","3","0","3","100"
"f_12792","127","3","0","3","100"
"f_13362","56","3","0","3","100"
"f_14032","81","3","0","3","100"
"f_14802","65","3","0","3","100"
"f_15822","203","3","0","3","100"
"f_16182","388","3","0","3","100"
"f_16642","163","3","0","3","100"
"f_17242","144","3","0","3","100"
"f_17492","51","3","0","3","100"
"f_18833","78","3","0","3","100"
"f_21323","54","3","0","3","100"
"f_21703","197","3","0","3","100"
"f_22953","44","3","0","3","100"
"f_24103","26","3","0","3","100"
"f_24983","795","3","0","3","100"
"f_26143","149","3","0","3","100"
"f_27653","306","3","0","3","100"
"f_33123","4","3","0","3","100"
"f_33721","36","3","0","3","100"
"f_36533","149","3","0","3","100"
"f_36583","302","3","0","3","100"
"f_37203","289","3","0","3","100"
"f_38613","128","3","0","3","100"
"f_41301","74","3","0","3","100"
"f_42212","133","3","0","3","100"
"f_42842","30","3","0","3","100"
"f_44802","54","3","0","3","100"
"f_44942","122","3","0","3","100"
"f_46982","27","3","0","3","100"
"f_47962","59","3","0","3","100"
"f_48661","60","3","0","3","100"
"f_7936","241","3","0","3","100"
"f_8029","573","3","0","3","100"
"f_8076","258","3","0","3","100"
"f_8532","390","3","0","3","100"
"f_8886","182","3","0","3","100"
"f_8979","128","3","0","3","100"
"f_9070","161","3","0","3","100"
"f_9176","80","3","0","3","100"
"f_9251","417","3","0","3","100"
"f_9394","288","3","0","3","100"
"f_9899","92","3","0","3","100"
"j_12043","132","3","0","3","100"
"j_12151","139","3","0","3","100"
"j_123","160","3","0","3","100"
"j_13681","21","3","0","3","100"
"j_13871","35","3","0","3","100"
"j_14271","40","3","0","3","100"
"j_410","405","3","0","3","100"
"j_4393","234","3","0","3","100"
"j_5693","48","3","0","3","100"
"j_99","1297","3","0","3","100"
"v_4783","616","3","0","3","100"
"v_8553","315","3","0","3","100"
"v_8583","491","3","0","3","100"
"a_128","100","4","1","3","75"
"a_2932","247","4","1","3","75"
"a_4563","388","4","1","3","75"
"a_7053","149","4","1","3","75"
"a_8541","12","4","1","3","75"
"f_10003","381","4","1","3","75"
"f_10588","121","4","1","3","75"
"f_14562","188","4","1","3","75"
"f_20383","16","4","1","3","75"
"f_22013","96","4","1","3","75"
"f_22353","54","4","1","3","75"
"f_23163","79","4","1","3","75"
"f_23713","190","4","1","3","75"
"f_24963","100","4","1","3","75"
"f_31801","26","4","1","3","75"
"f_41043","11","4","1","3","75"
"f_8288","265","4","1","3","75"
"f_8387","306","4","1","3","75"
"f_8477","368","4","1","3","75"
"f_8634","358","4","1","3","75"
"f_9843","181","4","1","3","75"
"f_9983","89","4","1","3","75"
"f_9985","43","4","1","3","75"
"j_11181","132","4","1","3","75"
"j_13193","37","4","1","3","75"
"j_300","45","4","1","3","75"
"j_416","92","4","1","3","75"
"j_6563","127","4","1","3","75"
"j_8213","176","4","1","3","75"
"v_1412","160","4","1","3","75"
"f_10476","69","5","2","3","60"
"f_11562","108","5","2","3","60"
"f_11652","31","5","2","3","60"
"f_16732","115","5","2","3","60"
"f_18073","234","5","2","3","60"
"f_24993","1442","5","2","3","60"
"f_32961","141","5","2","3","60"
"f_35573","20","5","2","3","60"
"f_38171","55","5","2","3","60"
"f_38581","14","5","2","3","60"
"f_48612","83","5","2","3","60"
"f_7971","1561","5","2","3","60"
"f_8570","395","5","2","3","60"
"j_2002","52","5","2","3","60"
"v_544","81","5","2","3","60"
"a_11222","25","2","0","2","100"
"a_1222","289","2","0","2","100"
"a_1242","119","2","0","2","100"
"a_1702","108","2","0","2","100"
"a_171","186","2","0","2","100"
"a_5153","375","2","0","2","100"
"a_5603","207","2","0","2","100"
"a_5661","33","2","0","2","100"
"a_5743","23","2","0","2","100"
"a_6443","371","2","0","2","100"
"a_7113","80","2","0","2","100"
"a_8393","11","2","0","2","100"
"f_10023","82","2","0","2","100"
"f_10194","144","2","0","2","100"
"f_10420","131","2","0","2","100"
"f_10448","33","2","0","2","100"
"f_10494","167","2","0","2","100"
"f_10508","1437","2","0","2","100"
"f_10604","107","2","0","2","100"
"f_10706","292","2","0","2","100"
"f_10734","65","2","0","2","100"
"f_10758","256","2","0","2","100"
"f_10800","448","2","0","2","100"
"f_11392","137","2","0","2","100"
"f_12012","122","2","0","2","100"
"f_12122","205","2","0","2","100"
"f_12622","28","2","0","2","100"
"f_12732","448","2","0","2","100"
"f_14232","2","2","0","2","100"
"f_14282","1865","2","0","2","100"
"f_16102","356","2","0","2","100"
"f_16312","42","2","0","2","100"
"f_16372","56","2","0","2","100"
"f_18273","576","2","0","2","100"
"f_18913","302","2","0","2","100"
"f_19623","192","2","0","2","100"
"f_19903","310","2","0","2","100"
"f_20963","881","2","0","2","100"
"f_21673","23","2","0","2","100"
"f_22043","366","2","0","2","100"
"f_22543","341","2","0","2","100"
"f_23363","91","2","0","2","100"
"f_24943","330","2","0","2","100"
"f_25183","161","2","0","2","100"
"f_26393","286","2","0","2","100"
"f_26843","227","2","0","2","100"
"f_27633","59","2","0","2","100"
"f_28543","392","2","0","2","100"
"f_28793","17","2","0","2","100"
"f_28963","58","2","0","2","100"
"f_29193","141","2","0","2","100"
"f_29453","64","2","0","2","100"
"f_34383","301","2","0","2","100"
"f_34481","73","2","0","2","100"
"f_36421","60","2","0","2","100"
"f_37183","101","2","0","2","100"
"f_37383","466","2","0","2","100"
"f_38301","84","2","0","2","100"
"f_38553","17","2","0","2","100"
"f_39073","155","2","0","2","100"
"f_42572","65","2","0","2","100"
"f_42832","34","2","0","2","100"
"f_43522","60","2","0","2","100"
"f_43691","46","2","0","2","100"
"f_45671","86","2","0","2","100"
"f_47282","93","2","0","2","100"
"f_47581","126","2","0","2","100"
"f_48592","41","2","0","2","100"
"f_49432","50","2","0","2","100"
"f_50171","18","2","0","2","100"
"f_7842","56","2","0","2","100"
"f_7857","297","2","0","2","100"
"f_8091","211","2","0","2","100"
"f_8183","147","2","0","2","100"
"f_8264","333","2","0","2","100"
"f_8285","169","2","0","2","100"
"f_8350","737","2","0","2","100"
"f_8370","199","2","0","2","100"
"f_8395","77","2","0","2","100"
"f_8430","271","2","0","2","100"
"f_8604","212","2","0","2","100"
"f_8752","254","2","0","2","100"
"f_8812","344","2","0","2","100"
"f_8823","1749","2","0","2","100"
"f_8904","115","2","0","2","100"
"f_8971","220","2","0","2","100"
"f_8976","332","2","0","2","100"
"f_9000","425","2","0","2","100"
"f_9013","177","2","0","2","100"
"f_9106","142","2","0","2","100"
"f_9136","463","2","0","2","100"
"f_9151","116","2","0","2","100"
"f_9154","143","2","0","2","100"
"f_9165","119","2","0","2","100"
"f_9233","113","2","0","2","100"
"f_9239","77","2","0","2","100"
"f_9269","146","2","0","2","100"
"f_9395","162","2","0","2","100"
"f_9462","111","2","0","2","100"
"f_9470","62","2","0","2","100"
"f_9497","35","2","0","2","100"
"f_9500","89","2","0","2","100"
"f_9547","397","2","0","2","100"
"f_9681","98","2","0","2","100"
"f_9708","679","2","0","2","100"
"f_9714","135","2","0","2","100"
"f_9738","120","2","0","2","100"
"f_9789","263","2","0","2","100"
"f_9832","360","2","0","2","100"
"f_9842","78","2","0","2","100"
"f_9849","257","2","0","2","100"
"f_9927","46","2","0","2","100"
"j_10353","493","2","0","2","100"
"j_10671","65","2","0","2","100"
"j_10753","63","2","0","2","100"
"j_11201","16","2","0","2","100"
"j_12993","52","2","0","2","100"
"j_13091","309","2","0","2","100"
"j_133","467","2","0","2","100"
"j_14612","15","2","0","2","100"
"j_14702","123","2","0","2","100"
"j_148","107","2","0","2","100"
"j_15132","25","2","0","2","100"
"j_15172","107","2","0","2","100"
"j_15222","138","2","0","2","100"
"j_15871","52","2","0","2","100"
"j_16032","16","2","0","2","100"
"j_16201","122","2","0","2","100"
"j_16221","514","2","0","2","100"
"j_16671","287","2","0","2","100"
"j_1732","337","2","0","2","100"
"j_1802","164","2","0","2","100"
"j_2522","92","2","0","2","100"
"j_3662","146","2","0","2","100"
"j_458","89","2","0","2","100"
"j_5883","25","2","0","2","100"
"j_6053","82","2","0","2","100"
"j_6473","811","2","0","2","100"
"j_7013","150","2","0","2","100"
"j_702","66","2","0","2","100"
"j_7843","53","2","0","2","100"
"j_8003","48","2","0","2","100"
"j_89","425","2","0","2","100"
"j_9901","304","2","0","2","100"
"v_12401","128","2","0","2","100"
"v_1402","981","2","0","2","100"
"v_515","454","2","0","2","100"
"v_622","8","2","0","2","100"
"v_9033","30","2","0","2","100"
"a_3783","97","3","1","2","66.6666666666667"
"a_396","243","3","1","2","66.6666666666667"
"a_5713","5","3","1","2","66.6666666666667"
"a_9851","86","3","1","2","66.6666666666667"
"f_10025","207","3","1","2","66.6666666666667"
"f_10742","318","3","1","2","66.6666666666667"
"f_13732","25","3","1","2","66.6666666666667"
"f_14102","138","3","1","2","66.6666666666667"
"f_15412","72","3","1","2","66.6666666666667"
"f_17272","190","3","1","2","66.6666666666667"
"f_18803","229","3","1","2","66.6666666666667"
"f_20523","69","3","1","2","66.6666666666667"
"f_22753","45","3","1","2","66.6666666666667"
"f_23063","565","3","1","2","66.6666666666667"
"f_25603","106","3","1","2","66.6666666666667"
"f_26113","16","3","1","2","66.6666666666667"
"f_26623","21","3","1","2","66.6666666666667"
"f_27453","974","3","1","2","66.6666666666667"
"f_27833","320","3","1","2","66.6666666666667"
"f_29663","14","3","1","2","66.6666666666667"
"f_30753","8","3","1","2","66.6666666666667"
"f_31253","141","3","1","2","66.6666666666667"
"f_33153","22","3","1","2","66.6666666666667"
"f_42182","7","3","1","2","66.6666666666667"
"f_44972","85","3","1","2","66.6666666666667"
"f_48081","40","3","1","2","66.6666666666667"
"f_7913","457","3","1","2","66.6666666666667"
"f_9240","178","3","1","2","66.6666666666667"
"j_11371","90","3","1","2","66.6666666666667"
"j_12113","2008","3","1","2","66.6666666666667"
"j_344","639","3","1","2","66.6666666666667"
"j_6653","127","3","1","2","66.6666666666667"
"j_7323","33","3","1","2","66.6666666666667"
"v_2102","65","3","1","2","66.6666666666667"
"a_10111","22","1","0","1","100"
"a_10121","55","1","0","1","100"
"a_10451","10","1","0","1","100"
"a_11201","72","1","0","1","100"
"a_11292","109","1","0","1","100"
"a_11552","82","1","0","1","100"
"a_11692","20","1","0","1","100"
"a_11902","113","1","0","1","100"
"a_12501","28","1","0","1","100"
"a_12762","52","1","0","1","100"
"a_1952","64","1","0","1","100"
"a_257","901","1","0","1","100"
"a_3292","185","1","0","1","100"
"a_330","39","1","0","1","100"
"a_380","112","1","0","1","100"
"a_3843","1509","1","0","1","100"
"a_39","243","1","0","1","100"
"a_4113","156","1","0","1","100"
"a_514","31","1","0","1","100"
"a_5593","130","1","0","1","100"
"a_6283","28","1","0","1","100"
"a_7223","333","1","0","1","100"
"a_7883","26","1","0","1","100"
"a_79","147","1","0","1","100"
"a_8081","50","1","0","1","100"
"a_93","639","1","0","1","100"
"a_9571","88","1","0","1","100"
"a_9961","22","1","0","1","100"
"f_10007","18","1","0","1","100"
"f_10086","48","1","0","1","100"
"f_10176","238","1","0","1","100"
"f_10280","418","1","0","1","100"
"f_10354","303","1","0","1","100"
"f_10356","8","1","0","1","100"
"f_10374","197","1","0","1","100"
"f_10418","38","1","0","1","100"
"f_10436","770","1","0","1","100"
"f_10466","153","1","0","1","100"
"f_10550","52","1","0","1","100"
"f_10624","1059","1","0","1","100"
"f_10708","205","1","0","1","100"
"f_10782","1513","1","0","1","100"
"f_10820","40","1","0","1","100"
"f_11122","175","1","0","1","100"
"f_11172","66","1","0","1","100"
"f_11772","246","1","0","1","100"
"f_11912","128","1","0","1","100"
"f_12042","319","1","0","1","100"
"f_12252","140","1","0","1","100"
"f_12562","90","1","0","1","100"
"f_12652","148","1","0","1","100"
"f_13292","212","1","0","1","100"
"f_13512","15","1","0","1","100"
"f_13882","179","1","0","1","100"
"f_14172","429","1","0","1","100"
"f_14462","153","1","0","1","100"
"f_14682","579","1","0","1","100"
"f_15352","56","1","0","1","100"
"f_16302","108","1","0","1","100"
"f_16522","294","1","0","1","100"
"f_17662","106","1","0","1","100"
"f_17862","176","1","0","1","100"
"f_18973","46","1","0","1","100"
"f_19253","53","1","0","1","100"
"f_19703","448","1","0","1","100"
"f_20913","981","1","0","1","100"
"f_21153","11","1","0","1","100"
"f_21193","17","1","0","1","100"
"f_22023","10","1","0","1","100"
"f_22053","145","1","0","1","100"
"f_22103","21","1","0","1","100"
"f_22213","12","1","0","1","100"
"f_23103","457","1","0","1","100"
"f_23443","683","1","0","1","100"
"f_23893","108","1","0","1","100"
"f_24843","45","1","0","1","100"
"f_24933","84","1","0","1","100"
"f_25673","105","1","0","1","100"
"f_26263","14","1","0","1","100"
"f_26423","131","1","0","1","100"
"f_26873","40","1","0","1","100"
"f_26893","248","1","0","1","100"
"f_27073","45","1","0","1","100"
"f_27683","29","1","0","1","100"
"f_27863","82","1","0","1","100"
"f_27873","28","1","0","1","100"
"f_28023","210","1","0","1","100"
"f_28053","25","1","0","1","100"
"f_28103","117","1","0","1","100"
"f_28933","8","1","0","1","100"
"f_29103","69","1","0","1","100"
"f_29243","257","1","0","1","100"
"f_29293","7","1","0","1","100"
"f_29633","5","1","0","1","100"
"f_31433","9","1","0","1","100"
"f_31533","53","1","0","1","100"
"f_31733","83","1","0","1","100"
"f_32051","25","1","0","1","100"
"f_32173","12","1","0","1","100"
"f_32951","1","1","0","1","100"
"f_32971","202","1","0","1","100"
"f_33223","108","1","0","1","100"
"f_34073","28","1","0","1","100"
"f_34403","121","1","0","1","100"
"f_35133","58","1","0","1","100"
"f_35691","13","1","0","1","100"
"f_35833","48","1","0","1","100"
"f_36851","82","1","0","1","100"
"f_38121","214","1","0","1","100"
"f_38311","35","1","0","1","100"
"f_38341","14","1","0","1","100"
"f_38993","6","1","0","1","100"
"f_39043","37","1","0","1","100"
"f_39603","9","1","0","1","100"
"f_39681","13","1","0","1","100"
"f_39781","407","1","0","1","100"
"f_39901","58","1","0","1","100"
"f_39911","104","1","0","1","100"
"f_40091","19","1","0","1","100"
"f_40373","63","1","0","1","100"
"f_40583","26","1","0","1","100"
"f_40801","55","1","0","1","100"
"f_41053","5","1","0","1","100"
"f_41271","33","1","0","1","100"
"f_41741","25","1","0","1","100"
"f_41771","123","1","0","1","100"
"f_41781","46","1","0","1","100"
"f_41923","28","1","0","1","100"
"f_41973","164","1","0","1","100"
"f_42222","47","1","0","1","100"
"f_42552","25","1","0","1","100"
"f_42592","51","1","0","1","100"
"f_42622","1","1","0","1","100"
"f_42812","57","1","0","1","100"
"f_43512","39","1","0","1","100"
"f_43651","58","1","0","1","100"
"f_43971","71","1","0","1","100"
"f_44082","35","1","0","1","100"
"f_44231","43","1","0","1","100"
"f_45922","62","1","0","1","100"
"f_45972","11","1","0","1","100"
"f_46111","153","1","0","1","100"
"f_46192","93","1","0","1","100"
"f_46212","125","1","0","1","100"
"f_46282","50","1","0","1","100"
"f_46292","21","1","0","1","100"
"f_46322","143","1","0","1","100"
"f_47411","39","1","0","1","100"
"f_48142","49","1","0","1","100"
"f_48651","64","1","0","1","100"
"f_49842","16","1","0","1","100"
"f_7790","259","1","0","1","100"
"f_7910","481","1","0","1","100"
"f_7946","538","1","0","1","100"
"f_8040","604","1","0","1","100"
"f_8111","440","1","0","1","100"
"f_8131","336","1","0","1","100"
"f_8141","76","1","0","1","100"
"f_8200","1580","1","0","1","100"
"f_8282","669","1","0","1","100"
"f_8296","176","1","0","1","100"
"f_8297","151","1","0","1","100"
"f_8326","159","1","0","1","100"
"f_8385","179","1","0","1","100"
"f_8386","170","1","0","1","100"
"f_8414","104","1","0","1","100"
"f_8438","313","1","0","1","100"
"f_8470","62","1","0","1","100"
"f_8506","203","1","0","1","100"
"f_8510","100","1","0","1","100"
"f_8550","23","1","0","1","100"
"f_8551","435","1","0","1","100"
"f_8556","231","1","0","1","100"
"f_8622","358","1","0","1","100"
"f_8667","145","1","0","1","100"
"f_8674","130","1","0","1","100"
"f_8680","138","1","0","1","100"
"f_8728","157","1","0","1","100"
"f_8732","227","1","0","1","100"
"f_8772","115","1","0","1","100"
"f_8776","148","1","0","1","100"
"f_8785","412","1","0","1","100"
"f_8814","116","1","0","1","100"
"f_8829","273","1","0","1","100"
"f_8854","312","1","0","1","100"
"f_8855","524","1","0","1","100"
"f_8925","257","1","0","1","100"
"f_8947","340","1","0","1","100"
"f_8974","197","1","0","1","100"
"f_8985","420","1","0","1","100"
"f_8999","574","1","0","1","100"
"f_9083","562","1","0","1","100"
"f_9091","376","1","0","1","100"
"f_9096","152","1","0","1","100"
"f_9097","330","1","0","1","100"
"f_9101","176","1","0","1","100"
"f_9193","71","1","0","1","100"
"f_9204","132","1","0","1","100"
"f_9213","190","1","0","1","100"
"f_9220","262","1","0","1","100"
"f_9249","25","1","0","1","100"
"f_9278","716","1","0","1","100"
"f_9284","152","1","0","1","100"
"f_9285","226","1","0","1","100"
"f_9286","105","1","0","1","100"
"f_9297","183","1","0","1","100"
"f_9311","50","1","0","1","100"
"f_9377","734","1","0","1","100"
"f_9456","108","1","0","1","100"
"f_9468","190","1","0","1","100"
"f_9485","50","1","0","1","100"
"f_9499","1620","1","0","1","100"
"f_9502","112","1","0","1","100"
"f_9510","345","1","0","1","100"
"f_9550","282","1","0","1","100"
"f_9580","102","1","0","1","100"
"f_9814","137","1","0","1","100"
"f_9850","327","1","0","1","100"
"j_10103","60","1","0","1","100"
"j_10843","30","1","0","1","100"
"j_11","185","1","0","1","100"
"j_11303","66","1","0","1","100"
"j_11623","54","1","0","1","100"
"j_11833","106","1","0","1","100"
"j_11863","1969","1","0","1","100"
"j_11951","308","1","0","1","100"
"j_12011","68","1","0","1","100"
"j_12461","334","1","0","1","100"
"j_12521","226","1","0","1","100"
"j_12661","304","1","0","1","100"
"j_12723","88","1","0","1","100"
"j_12811","147","1","0","1","100"
"j_12893","117","1","0","1","100"
"j_13021","39","1","0","1","100"
"j_13061","47","1","0","1","100"
"j_13233","38","1","0","1","100"
"j_135","215","1","0","1","100"
"j_13911","23","1","0","1","100"
"j_13972","58","1","0","1","100"
"j_14042","127","1","0","1","100"
"j_14372","28","1","0","1","100"
"j_14832","31","1","0","1","100"
"j_15031","68","1","0","1","100"
"j_15041","48","1","0","1","100"
"j_15231","204","1","0","1","100"
"j_15371","61","1","0","1","100"
"j_15642","73","1","0","1","100"
"j_15751","42","1","0","1","100"
"j_15781","40","1","0","1","100"
"j_15961","49","1","0","1","100"
"j_16261","41","1","0","1","100"
"j_198","788","1","0","1","100"
"j_2472","125","1","0","1","100"
"j_2632","258","1","0","1","100"
"j_28","268","1","0","1","100"
"j_303","895","1","0","1","100"
"j_3082","593","1","0","1","100"
"j_315","397","1","0","1","100"
"j_3322","166","1","0","1","100"
"j_394","12","1","0","1","100"
"j_419","306","1","0","1","100"
"j_4463","134","1","0","1","100"
"j_4603","34","1","0","1","100"
"j_493","21","1","0","1","100"
"j_4993","52","1","0","1","100"
"j_5423","148","1","0","1","100"
"j_548","2759","1","0","1","100"
"j_5533","49","1","0","1","100"
"j_5753","72","1","0","1","100"
"j_6","62","1","0","1","100"
"j_6183","87","1","0","1","100"
"j_65","437","1","0","1","100"
"j_650","252","1","0","1","100"
"j_6511","205","1","0","1","100"
"j_666","4","1","0","1","100"
"j_7093","134","1","0","1","100"
"j_722","450","1","0","1","100"
"j_8073","143","1","0","1","100"
"j_8143","602","1","0","1","100"
"j_83","129","1","0","1","100"
"j_8493","158","1","0","1","100"
"j_8503","39","1","0","1","100"
"j_8593","143","1","0","1","100"
"j_8633","5","1","0","1","100"
"v_1042","418","1","0","1","100"
"v_10863","84","1","0","1","100"
"v_12663","180","1","0","1","100"
"v_14712","32","1","0","1","100"
"v_1622","3939","1","0","1","100"
"v_16492","21","1","0","1","100"
"v_1702","566","1","0","1","100"
"v_196","194","1","0","1","100"
"v_247","3548","1","0","1","100"
"v_254","625","1","0","1","100"
"v_46","2836","1","0","1","100"
"v_560","253","1","0","1","100"
"v_5803","300","1","0","1","100"
"v_736","703","1","0","1","100"
"v_9673","62","1","0","1","100"